1E1111111
1P0011011
100C11011
100011011
100011011
11111111