1E1111111
1P0011011
100011011
100011011
100011011
111111111