111111111111
1P0000001C11
110000001111
100000000001
10000E000001
1100000C0011
111110001111
111111111111