1111111111111111111111111111111111111111
1P00010000110000000000000000000000110001
1100010000110000000000000000000000111111
1000011000010000000000000000000000110001
1111000000010100000000000000000000111111
1101110C10000100000000000000000000011001
1111110111110100000000000000000000011111
1000000000000000111111111111111111000001
1000000000000100010001C00000000000000001
1000000000000100000111111111100000000C01
1000000000000100111111111111111111111111
1000000000000100001010000000000000000001
1000000000000100000000000010000000000001
1111100000000100010010000000000000000001
1000000000000100001010000010000000000001
1001111111111101000000000000000000000001
1000000000000100001000000010000C00000001
1111111111000101000010010000000000100001
10CE1100C0000100000000000010000000000001
10011100000001000010001000000C0001111011
1000000000000100001000000000000000000011
1111111111111111111111111111111111111111