11111111111111111111111111111111
101111111C1100000000000000000001
10000000001000000000000000000001
10111111111000000000000000000001
10000000000100000000000000000001
111111111110000P0000000000000001
11000000000000000000000000000001
1000000000000CC000000000000000C1
100000000000000000000000000001E1
10000000000000000000000000000001
10000000000000000000000000000001
10000000000000000111000000000001
100000000000000001C0000000000001
11111111111111111111111111111111