111111111111
10P00C0CE101
111111111101
100000000001
111111111111