111111111111
1P0001000011
110001000011
100001100001
11110E010001
1101110C1011
111111011111
111111111111