1111111111111111111111111111111111111111
1P00010000110000000000000000000000110001
1100010000110000000000000000000000111111
1000011000010000000000000000000000110001
1111000000E10000000000000000000000111111
1101110C10110000000000000000000000110001
1111110111110000000000000000000000111111
1111111111111111111111111111111111111111
1111111111111111111111111111111111111111
1111111111111111111111111111111111111111
1111111111111111111111111111111111111111
1111111111111111111111111111111111111111
1111111111111111111111111111111111111111
1111111111111111111111111111111111111111
1111111111111111111111111111111111111111
1111111111111111111111111111111111111111
1111111111111111111111111111111111111111
1111111111111111111111111111111111111111
1111111111111111111111111111111111111111
1111111111111111111111111111111111111111
1111111111111111111111111111111111111111
1111111111111111111111111111111111111111